11111111111111111111111111111111111111
1P000000000000000000000000000000000001
1C00000000000000000000000000000000E001
1000000000000000000000000C000000000001
10000000000000000000000000000000000001
1000000000CCCCC00000000000000000000001
10000000000000000000000000000000000001
10000000000000000000000000000000000001
10000000000000000000000000000000000001
10000000000000000000000000000000000001
10000000000000000000000000000000000001
10000000000000000000000000000000000001
10000000000000000000000000000000000001
10000000000000000000000000000000000001
1000000000000CC00CC0000000000000000001
10000000000000000000000000000000000001
100000000000CC0C0000000000000000000001
10000000000000000000000000000000000001
10000000000000000000000000000000000001
11111111111111111111111111111111111111