11111111111111111111111111111111111111
1P000000000000000000000000000000000001
1C0000000000000111111000000000000000E1
1000000000000000000000000C000000000001
10000000000000000000000000000000000001
1000000000CCCCC00000000000000000000001
10000000000000000000000000000000000001
10000000000000000000000000000000000001
10000000000000011111111100000000000001
10000000000000000011100000111111110001
10000000000000000001000000000000000001
10000000000000000001000100000000000001
10000000000000000000000000000000000001
10000000000000000000000000000000000001
1000000000000CC00CC0000000000000000001
10000000000000000000000000000000000001
100000000000CC0C0000000000000000000001
10000000000000000000000000000000000001
10000000000000000000000000000000000001
11111111111111111111111111111111111111