111111
100001
10P001
111111
55555