11111111111111
100000000C0001
100000000C0001
100000000E0001
100000000P0001
10000000000001
10000000000001
11111111111111