111111
10E001
100001
100001
100001
100001
100001
10P001
111111
100001
11C111
11C111
11C111
11C111
11C111
111111