1111111111111111111111111111111111
10000B00000B00C00000C00000000000E1
101001010010B000010100100000001011
1010010010101010001001000000010101
1P0000000C00C0000000000B00000000C1
1111111111111111111111111111111111