1111111111111111111111111111111111
10000000000000C00000C00000B00000E1
10100101001000B01010010000B0001011
1000010010101010001001000000010101
1P0000000C00C000B000000000000000C1
1111111111111111111111111111111111