11111111111111111111111111111111111111
1P000000000000000000000000000000000001
1C0000000000000000000000000000C00000E1
1000000000000000000000000C000000000001
10000000000000000000000000000000000001
1000000000CCCCC00000000000000000000001
10000000000000000000000000000000000001
100000000000B00000000000000000000000C1
1000000000000000000000000000000C010C01
10000000000000000000000000000000000001
100000000000000000B0000000000000000001
10000111111111111111111111111111111001
10000000000000000000001111000000000001
100000000000000000B0001111000000000001
10000000B0000CC00CC0000000000000000001
10000000000000B00000001111000000000001
100000000000CC0C0000001111000000000001
10000000000000000000000000000000000001
10000000000000000000001111000000000001
11111111111111111111111111111111111111