1111111111111
1P00000000001
1111111111101
1BBBBC0000001
1011111111011
1000B0C000011
1111111111011
10E0000000001
1111111111111